11111111111111111111111111
1P0000E1111111111111111111
100C0001111111111111111111
10000010111111111111111111
100C0001111111111111111111
11111111111111111111111111
