11111111
10000001
110E0001
11110001
1P000C01
100C0001
11111111
