11111111
10000001
11000001
11110001
10000001
10000001
11111111
