11111111
1P0000E1
100C0001
11000101
100C0001
11111111
