111111111
100E00011
11P0CC101
10000C011
111111111
